1111111111111111111111111111111111
1E00000P0000C0C0000000000010010C01
1110010100100000101001000010010101
1010010010101010001001000010010111
1000000000000000000000000000000001
1111111111111111111111111111111111
