1111111111111111111111111111111111
100000000000000C0000C100000000E011
1010010100100000101011000000011111
1010010010101010001001000000010101
1P0000000C00C0000000000000000000C1
1111111111111111111111111111111111