1111111111111
1001000000PC1
100C011111001
1100111EC0001
1111111111111