1111111111111
1001000000PC1
100C011111001
1100111E00001
1111111111111