1111111111
1P00C111C1
10C1000101
1100010101
1101011101
110000C101
1101011101
1011010101
1C00001001
1100000001
1101000001
10C0110001
11100110E1
1111101101
1111111111